абонемент	[на что]
абонент	[чего]
абонироваться	[на что]
абстрагировать	[что]
абстрагироваться	[от чего]
аванс	[на что]
авария	[чего, с чем]
агитировать	[за кого-что]
агрессия	[куда, где]
акклиматизировать	[что]
аккомпанемент	[чего]
аккредитовать	[где, куда]
акт	[чего, на что, о чем, против чего]
акцент	[на что, на чем, ставить, сделать]
акцентировать	[что, на чем]
алчный	[до чего, к чему, на что]
альтернатива	[чему]
амнистия	[кому, для кого]
анализировать [что, с чем]
аналогичный	[чему, с чем]
аналогия	[с чем, между чем]
анекдот	[о ком-чем]
аннотация	[на что, чего]
аномалия	[в чем]
анонс	[о чем]
антипатия	[кого, к кому-чему]
антология	[чего]
апеллировать	[к кому-чему]
аппетит	[к чему, на что]
аргументировать	[что, чем]
арест	[на что]
ассигновать	[что, на что, для чего]
ассистировать	[кому]
ассоциировать	[что с чем]
атака	[на кого-что, против кого-что]
атаковать	[что, чем]
атрибут	[кого-чего]
атрофироваться	[от чего]
аттестация	[кого, о ком-чем, о чем]
аудиенция	[кому]
аукцион	[чего]
афера	[с чем]
базировать	[что, на чем]
базироваться	[на чем, на что]
бактеризовать	[что]
баллотировать	[кого-что]
баллотироваться	[куда]
баловаться	[чем, с чем, с кем]
барабанить	[во что, по чему]
баррикадировать	[что]
бахвалиться	[чем]
бегать	[от кого-чего, кого-чего]
бежать	[от кого-чего, кого-чего]
бедный	[чем, в чем, на что]
безвредный	[для кого-чего]
беззащитный	[против кого-чего, перед кем-чем]
безопасный	[для кого-чего]
безоружный	[перед чем]
безотносительный	[к чему]
безразличный	[для кого, кому]
безукоризненный	[в чем]
безупречный	[в чем]
безутешный	[в чем]
безучастный	[к чему]
бередить	[что, чем]
беречь	[кого-что, от кого-чего]
беречься	[кого-чего, от чего]
беспокоиться	[о ком-чем, за кого-что]
бесполезный	[для кого-чего]
беспомощный	[перед кем-чем]
беспощадный	[к кому-чему]
беспримерный	[в чем]
беспринципный	[в чем]
беспристрастный	[в чем]
бессильный	[перед кем-чем]
бесцельный	[для кого-чего]
биться	[над чем, с чем]
благо:	[кому, чего]
благоволить	[к кому, кому]
благоговеть	[перед кем-чем]
благодарный	[кому]
благодаря	[кому-чему, кого-чего]
благополучный	[для кого-чего]
благоприятный	[для кого-чего]
благоприятствовать	[кому-чему]
благосклонный	[к кому]
благотворный	[кому-чему]
близкий	[кому-чему, к кому-чему]
близость	[к кому, с кем]
богатый	[чем, на что]
бойкот	[кого-чего]
бойкотировать	[кого-что]
болезни	[кого, среди кого]
болеть	[за кого-что, о ком-чем, чем]
болтать	[что, о чем]
больно	[кому, что]
бороться	[с кем-чем, против кого-чего, с чем, против чего]
борьба	[с кем-чем, против кого-чего, с чем, против чего]
бояться	[кого]
бравировать	[чем]
брать	[от кого, у кого, с кого]
браться	[за что]
бредить	[чем]
брести	[куда, где]
брикетировать	[что]
бросать (бросить)	[что, чем]
бросить	[куда, где]
броситься	[на что, кому, к кому]
брызгать	[что, чем]
будить	[в ком, у кого]
будоражить	[кого-что, чем]
бунтовать	[кого, против кого-чего]
важно	[кому, для кого]
валить	[во что, на что, где, куда]
варьировать	[что, чем]
вбить	[что, во что]
вблизи	[чего, от чего]
вбросить	[что, во что]
ввалить	[что, во что]
ввезти (ввозить)	[что, во что, куда]
ввергнуть	[кого-что, во что, куда]
вверить	[кого-что, кому-чему]
ввернуть	[что, во что]
вверстать	[что, во что]
ввести	[кого-что, во что, куда]
ввинтить	[что, во что]
ввить	[что, во что]
вволочь	[что, во что]
ввязать	[кого-что, во что]
вдавить	[что, во что]
вдвинуть	[что, во что]
вделать	[что, во что]
вдернуть	[что, во что]
вдеть	[что, во что]
вдогонку	[кому, за кем]
вдолбить	[что, во что]
вдохновить	[кого-что, на что]
вдохнуть	[что в кого-что]
ведать	[что, чем]
ведомость	[чего, на что]
вежливый	[с кем, по отношению к кому]
велик	[чем, в чем]
величать	[кого кем]
венец	[чего, чему]
вербовать	[кого, на что, куда]
верить	[во что, чему]
вернуть	[кому, что]
верный	[кому, чему, в чем]
вертеть	[что, чем]
верховодить	[кем-чем]
вершить	[чем, что]
вешать	[на что, на чем, куда, где]
вжать	[что, во что]
взаимодействие	[кого-чего, между кем-чем, кого-чего, с кем-чем]
взаимосвязь	[чего, между чем]
взвалить	[что, на кого-что]
взвести	[кого, на что, что, на кого]
взгромоздить	[что, на что]
вздыхать	[о ком-чем, по кому-чему, по ком-чем]
взыскивать	[с кого, от кого, у кого]
взыскующий	[чего]
взять	[что, чего, от кого, у кого, с кого]
видеть:	[во что, в чем]
видный	[собой, из себя]
вина:	[чего, чему]
винить	[в чем, за что]
виниться	[перед кем]
виноват	[в чем, чем]
виртуоз	[чего, в чем]
вкинуть	[что, во что]
вкладывать (вложить)	[во что, где, куда]
вклинить	[что, во что]
включить	[кого-что, во что]
вколотить	[что в кого-что]
вколоть	[что, во что]
вкрутить	[что, во что]
вкусить	[чего, что]
властвовать	[над кем-чем, кем-чем]
властелин	[чего, над чем]
влепить	[что, во что]
влить	[что, чего]
вмазать	[что, во что]
вменить	[кому, что, во что]
вмесить	[что, во что]
вместилище	[чего, для чего]
вместить	[что, во что]
вмешать	[кого-что, во что]
вмещать	[куда, где, во что]
вмонтировать	[что, во что]
вмуровать	[что, во что]
вмять	[что, во что]
внедрить	[куда, что]
внести	[кого-что, куда]
внимательный	[к кому-чему]
внимать (внять)	[кому-чему]
вобрать	[что, во что]
вовлечь	[кого, во что]
вогнать	[кого-что, во что]
водворить	[куда, где]
водить	[чем по чему]
войти	[куда]
водрузить	[где, на чем]
воевать	[с кем-чем, против кого-чего]
возбудить	[в ком, у кого]
возвестить	[что, о чем]
возвратить	[кому, что]
воздать	[что, чем]
воздержаться	[от чего]
возиться	[над чем, с чем]
возложить	[на кого-что, к чему, на кого, на что]
возместить	[что, чем]
возможность (возможности)	[чего, для чего]
возмутить	[кого, чем]
возмущение	[против кого-чего]
вознаградить	[кого, за что]
вознегодовать	[на кого-что]
возразить	[против чего, на что]
война	[с кем-чем, против кого-чего]
волноваться	[за кого-что, о ком-чем]
вонзить	[что во кого-что]
воодушевить	[кого, на что]
вопить	[по кому, по ком]
воплотить	[в ком-чем, во что]
воспитывать	[в ком, у кого]
воспоминание (воспоминания)	[чего, о ком-чем]
восприимчивый	[к чему]
воспринять	[что, от кого]
воспротивиться	[чему]
восстановить	[что, в чем, против кого-чего]
восстать	[против кого-чего, на кого]
восторгать	[кого]
восторгаться	[чем]
восторжествовать	[над кем-чем]
восхитить (восхищать )	[кого, чем]
восхититься (восхищаться)	[кем-чем]
восхищение	[кем-чем, от чего, перед чем]
восходить	[к чему]
вотировать	[что, за кого-что, против кого-чего]
воткнуть	[что, во что]
вперить	[в кого-что, на кого-что]
вписать	[что, во что]
впихнуть	[кого-что, во что]
вплести	[что, во что]
впрыснуть	[что, во что]
впрясть	[что, во что]
впутать	[кого-что, во что]
враг	[чего, чему]
вражда	[кого, между кем]
вращать	[что, чем]
вред	[чему, для чего]
вредный (вреден)	[кому, для кого]
врезать	[что, во что]
врубить	[что, во что]
вручить	[кому, что]
вселить	[кого-что, куда, во что]
вслед	[кому-чему, за кем-чем]
вспомнить	[что, о чем]
вставить (вставлять)	[во что, где, куда]
встать	[куда, где]
встречать	[что, кого, в чем]
встроить	[что, во что]
встряхнуть (встряхивать)	[что, чем]
всунуть	[что, во что]
всыпать	[что, чего]
втащить	[что, куда]
втереть	[что, во что]
втиснуть	[что, во что]
втолкнуть	[кого-что, куда]
втоптать	[что, во что]
втравить	[кого, во что]
втянуть	[кого-что, во что]
вчувствоваться	[во что]
вшить	[что, во что]
выборы	[куда, где]
вывалить	[что, чего]
выведать	[от кого, у кого]
вывесить (вывешивать)	[что, куда]
выгодный	[для кого-чего, кому-чему]
выгрузить	[куда, где]
выдаться	[в кого]
выжидать	[что, чего]
вызвать	[в ком, у кого]
выиграть [кого, у кого, у чего]
выместить	[что на ком]
выносливый	[к чему]
выписать (выписывать)	[на что, на чем]
выпить	[что, чего]
выпросить	[что, чего]
вырасти	[в кого, кем]
высадить	[куда, где]
высадить	[куда, где]
высадиться	[куда, где]
выслать	[что, чего]
выставить	[куда, где]
выть	[по кому]
выучиться	[на кого]
гадать	[о чем]
гарантировать	[кому, что, кого от чего]
гарантия	[чего, чему, от чего, в чем]
гармонировать	[с чем]
гибельный	[для кого]
глава	[чего, из чего]
главенствовать	[над кем-чем]
гладить	[что, по чему]
глодать	[что]
глубокий	[чем, по чему]
глумиться	[над кем-чем]
глухой	[к чему]
глух	[к чему]
гнушаться	[кого-чего, кем-чем]
говорить	[что, о чем, за то]
годиться (пригодиться)	[для чего, на что, кому, для кого]
годный	[для чего, к чему, на что]
голосить	[по кому, по ком]
голосовать	[кого-что, за кого-что]
горазд	[на что]
горбить	[что]
гордиться	[кем-чем, за кого]
гордость	[за кого-что, кем-чем]
гордый (горд)	[кем-чем, за кого-что]
горевать	[о ком-чем, по кому-чему, по ком-чем]
горячить	[кого-что]
готовить	[кого-что, к чему, для чего]
готовиться	[к чему, на что]
готовый	[к чему, на что]
гравировать	[что, на чем]
граничить	[с чем]
грешить	[чем, против чего]
гримировать	[кого-что, кого кем]
грозить	[кому чем]
грозный	[чем, в чем]
грузить	[во что, на что, куда]
грустить	[о ком-чем, по кому-чему, по ком-чем]
грязнить	[что, чем]
губительный	[для кого-чего]
давить	[кого-что, на кого-что, кого - что]
дарить	[кому, что, кого, чем]
датировать	[что, чем]
дать	[что, чего]
двигать	[что, чем]
дезавуировать	[кого-что]
дезориентировать	[кого-что]
декларировать	[что]
декорировать	[что, чем]
дело	[к кому, до кого, для кого]
дело	[о чем, по чему]
денонсировать	[что]
депонировать	[что]
дергать	[что, за что, чем]
держаться	[чего]
дерзать	[на что]
деть	[куда]
дивиться	[чему, на что]
дисгармонировать	[с чем]
дисквалифицировать	[кого]
дискредитировать	[кого-что]
дискриминировать	[кого]
дискутировать (дискуссировать)	[что, о чем]
дислоцировать	[кого-что]
диспонировать	[чем]
дистиллировать	[что]
дисциплинировать	[кого-что]
дифференцировать	[что]
дичиться	[кого-чего]
добавить	[что, чего]
добиваться (добиться)	[от кого, у кого]
добрать	[что, чего]
добрый	[к кому, с кем]
добыть	[что, чего]
довезти	[кого, до чего]
доверие	[к кому-чему, кому-чему]
довершение:	[чего]
доверять	[что, в чем]
довести	[кого-что до чего]
довлеть	[кому-чему, над кем-чем]
договор	[о чем, на что]
догрузить	[что, чего]
додать	[что, чего]
дожидаться (дождаться)	[кого, чего, до чего]
дозволить	[что]
дозировать	[что]
дознаться	[чего, о чем]
доискиваться	[чего, до чего]
доказательство	[чего, чему]
доказать	[что, на кого]
документировать	[что, чем]
докупить	[что, чего]
докучать	[кому чем]
долбить	[что, чем]
долг	[кому, перед кем]
должать	[у кого]
долить	[что, чего]
доложить	[что, о чем]
доложить	[что, чего]
доля [кого, чего]
доминировать	[над чем]
донимать (донять)	[кого, чем]
дополнить	[что, чем]
допускать	[к кому-чему, до кого-чего]
допытываться (допытаться)	[у кого, от кого]
дорога	[чего, к чему]
досадить	[кому чем]
досадовать	[на кого-что]
доставить	[что, чего]
достать	[до чего, чего]
достать	[что, чего]
достигнуть (достичь)	[чего, до чего]
достойный	[кого-чего]
доступный	[кому-чему, для кого-чего]
досыпать	[что, чего]
драматизировать	[что]
драпировать	[что, чем]
драться	[с кем-чем, против кого-чего]
дрожать	[за кого-что, над кем-чем]
друг	[кого, кому]
дублированный	[на что, на чем]
думать	[что, о ком, о чем, над чем, на кого]
дым	[чего, от чего]
естественный	[для кого-чего]
жадность	[к чему, на что, до чего]
жадный	[на что, до чего, к чему, чего]
жажда	[чего, к чему]
жаждать	[чего, что]
жалеть	[кого-что, что, чего, о ком-чем]
жалкий	[в чем, чем]
жалко (жаль)	[кого-что, кого-чего, чего]
жаловать	[кого, чем, кому, что, к кому]
ждать	[чего, кого-что]
желать	[чего, кого-что, кому, для кого]
жертвовать	[что, чем]
жить	[чем, на что]
забавлять	[кого, чем]
забаллотировать	[кого]
забаррикадировать	[что]
забить	[что, во что]
забить	[что, чем]
заблагорассудится	[кому]
заболтать	[что, во что]
забросать	[кого-что, чем]
забросить	[что, на что]
забрызгать	[кого-что, чем]
забыть	[что, о чем]
завалить	[что, чем]
заведующий	[чем, чего]
заверить	[что, в чем]
завернуть	[кого-что, во что]
завершить	[что, чем]
завешать	[что, чем]
завидовать	[кому-чему]
завтракать (позавтракать)	[чем]
завязать	[что, чем]
заглотнуть	[что, чего]
заглядеться	[на кого-что]
заглянуть	[во что, кому, к кому]
загнать	[кого-что, во что]
загородить	[кого-что, чем]
загребать	[что, чем]
загромоздить	[что, чем]
загрузить	[что, чем]
задать	[что, чего]
задать	[что, чего]
задвинуть	[что, чем]
задернуть	[что, чем]
задеть	[что, за что]
задуматься	[над чем, о чем]
заесть	[что, чем]
заинтересовать	[кого, чем]
заинтриговать	[кого, чем]
заискивать	[перед кем, у кого, в ком]
зайтись	[от чего]
закатать	[что, во что]
закидать	[что, чем]
закинуть	[что, за что, на что]
заклеить	[что, чем]
заклеймить	[кого-что, чем]
заключить	[кого-что, во что, что, чем]
заколотить	[что, чем]
заколоть	[что, чем]
закон	[чего, о чем]
закопать	[куда, где]
закрепить	[что, чем, кого-что за кем-чем]
закрыть	[кого-что, чем]
закусить	[чем, что, чем, чего]
закутаться	[во что, чем]
залезть	[во что, кому, к кому]
залепить	[что, чем]
залечь	[куда, где]
залить	[что, чем]
заложенный	[куда, где, в ком-чем]
заложить (закладывать)	[куда, где]
заляпать	[что, чем]
замазать	[что, чем]
замарать	[что, чем]
замедлить	[что, с чем]
заменить	[кого-что, кем-чем]
заметить	[в чем, во что]
замешать	[кого, во что]
замешаться	[куда, где]
замещать (заместить)	[кого, чем]
замкнуться	[во что, в чем]
замолвить [что, перед кем, за кого]
замуровать	[где, в чем]
заниматься	[чем]
занять	[что, чего]
запамятовать	[что, о чем]
запасти	[что, чего]
запереть	[в чем, чем, на что]
записать (записывать)	[на чем, за кем, кому]
запить	[что, чем]
запихать (запихнуть)	[что, во что]
заплатить	[за что, что]
заповедать	[что]
заподозрить	[кого, в чем]
заполнить	[что, чем]
заправить	[что, чем]
запрещение	[чего, на что]
запросить	[что, чего, о чем]
запрятать	[куда, где]
запустить	[что, чем, что, во что-кого]
запутанность	[чего, в чем, с чем]
заражение	[чего, чем]
зарыть	[куда, где]
засадить	[что, чем]
заселить	[что, кем]
засесть	[куда, где]
засеять	[что, чем]
заслонить	[что, чем]
заслуживать	[чего, что]
заслужить	[что, чего]
заслушаться	[чего, чем]
засмотреться	[на кого-что]
заставить	[что, чем]
застлать	[что, чем]
засунуть	[что, во что]
засыпать	[что, чего]
затащить	[кого-что, куда]
заткнуть	[что, чем]
затмить	[кого, чем]
затоварить	[что, что, чем]
затоптать	[что, во что]
заточить	[куда, где]
затратить	[что, на что]
затянуть	[кого, во что]
захватить	[что, чего]
зацепить	[что, за что]
зачаровать	[кого, чем]
зачерпнуть	[что, чего]
зачислить	[кем, в кого]
защита	[от кого-чего, против кого-чего]
защитить	[кого-что, от кого-чего]
заявить	[что, о чем]
заявление	[о чем, на что]
злоба	[на кого-что, к кому-чему, против кого-чего]
знакомый	[с чем, кому-чему]
знаменательный	[для кого, чем]
знаменовать	[что]
знать	[что, о чем]
играть	[во что, на чем, с кем, против кого, чем, с чем]
идентичный	[чему]
идентифицировать	[что]
идея	[чего, о чем]
идти	[чем, по чему]
идти	[во что, на что, подо что]
идти	[кому, к кому]
идти	[чем, с чего]
избегать (избежать)	[чего, что]
избрать	[кем, в кого]
изведать	[что]
извериться	[в ком-чем, в кого-что, в чем]
известный	[кому, для кого]
извинить	[кого, за что, кому, что, кого, чем]
извлечь	[что из чего]
изволить	[чего]
изготовить	[что, чего]
издергать	[кого, чем]
изменение (изменения)	[чего, в чем]
изобильный (изобилующий)	[чем]
изобличить	[кого, в чем]
изойти	[чем]
изолировать	[кого, от кого-чего]
изощряться	[в чем]
изумиться (изумляться)	[чему]
изумленный	[чем]
изъять	[у кого, из чего]
именовать	[кого-что, кем-чем]
имитировать	[кого-что]
иммунитет	[к чему, против чего]
импонировать	[кому-чему]
импровизировать	[что]
импульс	[к чему, для чего]
имя	[кого-чего, кому-чему]
инициатива	[чего, в чем]
инкриминировать	[кому, что]
инкрустировать	[что, чем]
инспирировать	[кого-что]
инструктировать	[кого]
инструментовать	[что]
инсценировать	[что]
интегрировать	[что]
интенсифицировать	[что]
интервью	[кому, с кем]
интервьюировать	[кого]
интересный	[кому, для кого]
интриговать	[кого, против кого]
информировать	[кого о чем]
иронизировать	[над кем-чем]
искать	[что, где]
исключая	[что, кого-чего]
искупить	[что, чем]
искусный	[в чем]
искушенный	[в чем]
испачкать	[что, чем]
испестрить	[что, чем]
испечь	[что, чего]
испить	[чего, что]
исполненный	[чего, чем]
исполнить	[кого-что, чем]
использовать	[для чего, на что]
испытывать	[что]
испросить	[что, чего]
исследование	[чего, о чем]
история	[кого-чего, о ком-чем, про кого-что]
исходить	[от кого, от чего, из чего]
исчислить	[во что, чем]
исчисляться	[чем, во что]
итог	[чего, чему]
капитулировать	[перед кем-чем]
капут	[кому-чему]
карикатура	[чего, на кого-что]
касаться	[кого-чего, до кого-чего]
катастрофа	[чего, с чем]
качать	[кого-что, чем]
каюк	[кому]
кидать	[что, чем]
кинуться	[на что, к кому]
класть	[во что, где, куда]
клеить	[куда, где]
клеймить	[кого, чем]
ковырять	[что, в чем]
кодировать	[что]
колотить	[по чему, во что]
поколотить	[по чему, во что]
командование	[чего, чем]
командовать	[кем-чем, над кем-чем]
командующий	[чем, чего]
комбинация	[чего, с чем]
комментарий (комментарии)	[кого-чего, к чему]
компенсация	[чего, за что]
компенсировать	[что, чем]
компетентный	[в чем]
конгениальный	[чему]
конец	[чего, чему]
конкурировать	[с кем-чем, в чем, на что]
конкурс	[на что]
коноводить	[кем]
консультация	[кому]
консультировать	[кого]
консультироваться	[с кем, у кого]
контрабанда	[чего, чем]
контраст	[чего, с чем]
контрастировать	[с чем]
контроль	[за чем, над кем-чем, чего, над чем]
конфисковать	[что у кого]
кончить	[что, чем, на чем]
кончиться	[чем, на чем]
копия	[чего, с чего]
корить	[за что, чем]
корм	[кому, для кого]
короткий (короток)	[кому, для кого]
корректировать	[что, чем]
косить	[что, чем]
красить	[чем, во что]
кровоизлияние	[куда, где]
крутить	[что, чем]
купить	[что, чего, за что, на что, кому, для кого]
курировать	[кого-что, кем-чем]
курить	[что, чем]
лазить	[куда, где]
ласковый	[с кем, к кому]
лгать	[кому, на кого]
легко	[кому, для кого]
леденить	[что]
лекарство	[от чего, против чего]
лекция	[о чем, по чему]
ленивый (ленив)	[к чему, на что, в чем]
лепетать	[что, о чем]
лепить	[что, чем]
лечь	[на что, где]
лидировать	[в чем]
лить	[что]
лихой	[на что]
лицезреть	[кого-что]
лицемерить	[перед кем]
ложиться	[на что, где]
локаутировать	[кого]
лопнуть	[от чего, с чего]
лузгать (лускать)	[что]
лущить	[что]
льгота	[кому, для кого]
льститься	[на кого-что, кем-чем]
любезный	[с кем, по отношению к кому]
любоваться	[кем-чем, на кого-что]
мазать	[что, чем]
макать	[что, во что]
малоприспособленный	[для чего, к чему]
маневрировать	[кем-чем]
манить	[чем, на что]
манкировать	[чем, кому]
маркировать	[что]
мастер	[чего, на что]
материал	[на что, для чего]
матрицировать	[что]
матч	[кого с кем, между кем]
маять	[кого]
медлить	[с чем, чем]
межевать	[что]
мездрить	[что]
мельчить	[что]
мера	[чего, чему]
меры	[чего, по чему]
метать	[что, чем]
мигать	[кому, на кого-что]
милый	[с кем, кому-чему, для кого-чего]
мирволить	[кому, к кому]
мобилизация	[на что, для чего]
мобилизовать	[на что, для чего]
молить	[о чем, чего]
молиться	[кому-чему, на кого-что]
молнировать	[что, о чем]
молодить	[кого]
молотить	[во что, по чему]
монополия	[чего, на что]
мораторий	[на что]
мостить	[что, чем]
мотать	[кого-что, чем]
мотивировать	[что, чем]
мудрить	[над кем]
мурыжить	[кого]
мучиться	[над чем, с чем]
мчать	[кого]
мыслить	[что, о чем]
мытарить	[кого]
мыть	[чем, с чем, что]
мягкий	[с кем, по отношению к кому]
набавить	[что, чего]
набелить	[что, чего]
набить	[что, чего, что, чем]
наблюдать	[кого-что, за кем-чем, над кем-чем]
наблюдения	[за кем-чем, над кем-чем]
наболтать	[что, чего]
наболтать	[что, чего]
набормотать	[что, чего]
наборонить	[что, чего]
набрать	[что, чего]
набронзировать	[что, чего]
набросать	[что, чего]
набросить	[что, на что]
набрызгать	[что, чего]
навалить	[что, чего]
навалять	[что, чего]
наварить	[что, чего]
навезти	[что, чего]
навертеть	[что, чего]
навести	[что, на что]
навешать	[что, чего]
навешать	[что, чего]
нависнуть	[на что, над кем-чем]
навить	[что, чего]
навозить	[что, чего]
наволочь	[что, чего]
наворовать	[что, чего]
наворожить	[что, чего]
наворотить	[что, чего]
наворочать	[что, чего]
наворошить	[что, чего]
навыдумать	[что, чего]
навязать	[что, чего]
навялить	[что, чего]
нагатить	[что, чего]
нагладить	[что, чего]
наглушить	[что, чего]
наглянцевать	[что, чего]
нагнать	[кого-что, чего]
нагнать	[что, чего]
нагнать	[что, чего]
нагнать	[что, чего]
наговорить	[что, чего]
нагородить	[что, чего]
наготовить	[что, чего]
нагофрировать	[что, чего]
награбить	[что, чего]
награвировать	[что, чего]
награнить	[что, чего]
награфить	[что, чего]
нагрести	[что, чего]
нагромоздить	[что, чего]
нагрузить	[что, чем]
нагрызть	[что, чего]
нагулять	[что, чего]
надавать	[что, чего]
надарить	[что, чего]
надбавить	[что, чего]
наддать	[что, чего]
наделать	[что, чего]
надергать	[что, чего]
надеть	[что, что, на что]
надеяться	[на что, чего]
надзирать	[за кем-чем, что]
надоить	[что, чего]
надолбить	[что, чего]
надрать	[что, чего]
надубить	[что, чего]
надуть	[что, чего]
наесться	[чего, чем]
нажарить	[что, чего]
нажать	[что, чего]
нажать	[что, чего]
нажечь	[что, чего]
нажить	[что, чего]
назанимать	[что, чего]
назвать	[что, кого-чего]
наздравствоваться	[на что, с кем-чем]
наиграть	[что, чего]
наискаться	[чего]
найти	[что, в чем]
накапать	[что, чего]
накатать	[что, чего]
накатить	[что, чего]
накачать	[что, чего]
наквасить	[что, чего]
накидать	[что, чего]
накинуть	[что, на что]
накипятить	[что, чего]
наклеить	[куда, где]
наклеить	[что, чего]
наклепать	[что, чего]
наковать	[что, чего]
накоксовать	[что, чего]
наколдовать	[что, чего]
наколотить	[что, чего]
наколоть	[что, чего]
наколупать	[что, чего]
накомкать	[что, чего]
накопать	[что, чего]
накопать	[что, кого-чего]
накопить	[что, чего]
накоптить	[что, чего]
накорчевать	[что, чего]
накосить	[что, чего]
накрасить	[что, чего]
накрасть	[что, чего]
накрахмалить	[что, чего]
накроить	[что, чего]
накропать	[что, чего]
накрошить	[что, чего]
накрутить	[что, чего]
накрыть	[что, чем]
накупить	[что, чего]
накурить	[что, чего]
накусать	[что, чего]
накутать	[что, чего]
налакировать	[что, чего]
налгать	[кому, на кого]
налепить	[что, чего]
налетать	[что, чего]
налиновать	[что, чего]
налитографировать	[что, чего]
налить	[что, чего]
наловить	[что, кого-чего]
наложить	[что, чего]
наломать	[что, чего]
налудить	[что, чего]
налузгать	[что, чего]
налущить	[что, чего]
наляпать	[что, чего]
намазать	[что, чего]
намазюкать	[что, чего]
намарать	[что, чего]
намариновать	[что, чего]
намежевать	[что, чего]
намек	[на кого-что, о ком-чем]
намекать	[о чем, на кого-что]
намельчить	[что, чего]
наменять	[что, чего]
намерить	[что, чего]
намесить	[что, чего]
намести	[что, чего]
наметать	[что, чего]
намешать	[что, чего]
намолотить	[что, чего]
намолоть	[то, чего]
наморить	[что, кого-чего]
наморозить	[что, чего]
намотать.	[что, чего, что, на что]
намочить	[что, чего]
намыть	[что, чего]
намять	[что, чего]
нанести	[что, чего]
нанизать	[что, чего]
наносить	[что, чего]
нанять	[кем, в кого]
наобещать	[что, чего]
наострить	[что, чего]
наоткрывать	[что, чего]
напарить	[что, чего]
напасти	[что, чего]
напастись	[чего]
напахать	[что, чего]
напаять	[что, чего]
наперерез	[кому-чему, кого-чего]
напеть	[что, чего]
напечь	[что, чего]
напилить	[что, чего]
написать	[на чем, что]
напитать	[что, чем]
напихать	[что, чего]
наплавить	[что, чего]
наплескать	[что, чего]
наплести	[что, чего]
наплодить	[кого-что, кого-чего]
наплющить	[что, чего]
наполировать	[что, чего]
наполненный	[кем-чем, кого-чего]
наполнить	[что, чем]
наполоскать	[что, чего]
наполосовать	[что, чего]
наполоть	[что, чего]
напомнить	[что, о ком-чем]
напороть	[что, чего]
напортить	[что, чего]
направление:	[чего, к чему]
напринимать	[кого-что, кого-чего]
наприниматься	[чего]
напророчить	[что, чего]
напроситься	[чего, на что, в кого-что]
напрыскать	[что, чего]
напрясть	[что, чего]
напустить	[кого-что, кого-чего]
напутать	[что, чего]
напутствовать	[чем]
наработать	[что, чего]
нарадоваться	[на кого-что, кому-чему]
нарассказать	[что, чего]
нарастить	[что, чего]
нарвать	[что, чего]
нарезать	[что, чего]
народить	[кого-что, кого чего]
нарубать	[что, чего]
нарубить	[что, чего]
нарыть	[что, чего]
нарыть	[что, чего]
насадить	[что, чего]
насадить	[кого-что, кого-чего]
насажать	[кого-что, кого-чего]
насбивать	[что, чего]
насверлить	[что, чего]
населить	[что]
насечь	[что, чего]
насеять	[что, чего]
насильничать	[над кем]
насинить	[что, чего]
насказать	[что, чего]
наскоблить	[что, чего]
наскрести	[что, чего]
наскучить	[кем-чем]
наслать	[что, чего]
наследовать	[что (от кого), кому]
наслоить	[что, чего]
наслышанный	[о ком-чем]
насмешничать	[над кем-чем]
насмолить	[что, чего]
насмотреться	[кого-чего, на кого-что]
наснимать	[что, чего]
насобирать	[что, чего]
насовать	[что, чего]
насоветовать	[что, чего]
насоздавать	[что, чего]
насолить	[что, чего]
насортировать	[что, чего]
насосать	[что, чего]
насочинить (насочинять)	[что, чего]
наставить	[что, чего]
настегать	[что, чего]
настелить	[что, чего]
настирать	[что, чего]
настлать	[что, чего]
настрелять	[кого-что, кого-чего]
настричь	[что, чего]
настрогать	[что, чего]
настроить	[что, чего]
настроиться	[против кого-чего, к кому-чему, на что]
настрочить	[что, чего]
настругать	[что, чего]
настряпать	[что, чего]
настукать	[что, чего]
насудачить	[что, чего]
насулить	[что, чего]
насучить	[что, чего]
насушить	[что, чего]
насшибать	[что, чего]
насыпать	[что, чего]
натаскать	[что, чего]
натащить	[что, чего]
натаять	[что, чего]
натворить	[что, чего]
натворить	[что, чего]
натеребить	[что, чего]
натереть	[что, чего]
натесать	[что, чего]
натискать	[что, чего]
наткать	[что, чего]
натолкать	[что, чего]
натолочь	[что, чего]
натомить	[что, чего]
натопить	[что, чего]
наторговать	[что, чего]
наточить	[что, чего]
наточить	[что, чего]
натратить	[что, чего]
натрепать	[что, чего]
натрещать	[что, чего]
натрусить	[что, чего]
натрясти	[что, чего]
натушить	[что, чего]
натыкать	[что, чего]
наудить	[что, чего]
наутюжить	[что, чего]
научиться	[у кого, от кого]
нафабриковать	[что, чего]
нафантазировать	[что, чего]
нафаршировать	[что, чего]
наформовать	[что, чего]
нахапать	[что, чего]
нахватать	[что, чего]
нацедить	[что, чего]
нацелиться	[в кого-что, на что, против кого-чего]
начать	[чем, с чего]
начеканить	[что, чего]
начерпать	[что, чего]
начертить	[что, чего]
начесать	[что, чего]
начинать	[кем, с кого]
начинить	[что, чего]
начинить	[что, чем]
начиркать	[что, чего]
начистить	[что, чего]
нашвырять	[что, чего]
нашелушить	[что, чего]
нашептать	[что, чего]
нашинковать	[что, чего]
нашить	[что, чего]
нашпиговать	[что, чего]
наштамповать	[что, чего]
наштопать	[что, чего]
нащелкать	[что, чего]
нащепать	[что, чего]
нащипать	[что, чего]
наэкономить	[что, чего]
небезопасный	[для кого-чего]
небезразличный	[для кого, кому]
небезызвестный	[кому]
небезынтересный	[кому, для кого]
неблагосклонный	[к кому]
небогатый	[чем]
небречь	[чем, о чем]
невежественный	[в чем]
неверие	[во что, в чем]
невзвидеть	[чего]
невзлюбить	[кого-что]
невзыскательный	[на что]
невидимый	[кому]
невмешательство	[во что]
невоздержание	[в чем]
невоздержанность	[в чем, к чему]
невоздержанный (невоздержный)	[на что]
невосприимчивый	[к чему]
невыгодный	[для кого-чего, кому-чему]
неглижировать	[чем]
негодный	[для чего, к чему, на что]
негодовать	[на кого-что, против кого-чего]
недалекий (недалек)	[от чего]
недобрать	[что, чего]
недоварить	[что]
недоверие	[к кому-чему, кому-чему]
недовернуть	[что]
недовесить	[что, чего]
недовыполнить	[что]
недовыработать	[что, чего]
недовыручить	[что, чего]
недовязать	[что, чего]
недоглядеть	[что, чего, за кем-чем]
недоговорить (недоговаривать)	[что, чего]
недогрузить	[что, чего]
недодать	[что, чего]
недоделать	[что, чего]
недодержать	[что]
недоедать	[чего]
недожарить	[что, и чего]
недожать	[что, чего]
недожать	[что]
недожечь	[что]
недоиспользовать	[что]
недокармливать(недокормить)	[кого]
недолить	[что, и чего]
недоловить	[кого-что, кого-чего]
недомерить	[что, и чего]
недомолотить	[что, чего]
недомолоть	[что, чего]
недооценить	[что, чего]
недопаять	[что, и чего]
недопечь	[что, и чего]
недописать	[что]
недоплатить	[что, чего]
недопоить	[кого]
недополучить	[что, чего]
недопонять	[кого-что]
недопустимый	[для кого]
недоработать	[что]
недоразумение	[кого с кем, между кем]
недосеять	[что, чего]
недосказать	[что, чего]
недослать	[что, чего]
недослышать	[что, чего]
недосмотреть	[что, чего, за кем-чем]
недосолить	[что, чего]
недоставать	[кого-чего]
недоступный	[кому-чему, для кого-чего]
недосчитаться	[кого-чего]
недосы/пать	[что, чего]
недосягаемый	[для кого-чего]
недотянуть	[что]
недоукомплектовать	[кого-что]
недоучесть	[что, чего]
нежный	[к кому, с кем]
незабвенный	[для кого]
незабываемый	[для кого]
независимость	[чего, в чем]
независимый	[от кого-чего]
незадолго	[до чего, перед чем]
незнакомый	[с чем, кому-чему]
неизвестный	[кому, для кого]
неинтересный	[кому, для кого]
неистощимый	[в чем, на что]
некролог	[кому, о ком, кого]
ненавистный	[кому-чему, для кого-чего]
ненормальный	[для кого-чего]
ненужный	[кому, для кого-чего]
необузданный	[в чем]
необходимость	[чего, в ком-чем]
необходимый	[кому, для кого-чего, на что]
необычный	[для кого-чего]
неопытный	[в чем]
неотделимый	[от чего]
неповадно	[кому]
неповинный	[в чем]
неподражаемый	[в чем]
непоколебимый	[в чем]
непонятный	[кому, для кого]
непосильная	[для кого]
непоследовательный	[в чем]
непостижимый	[кому-чему, для кого-чего]
непохожий	[на кого-что]
непочтительный	[к кому]
непреклонный	[в чем]
непривычный	[для кого-чего]
непригодный	[для чего, к чему]
неприемлемый	[для кого-чего]
неприменимый	[в чем]
непримиримость	[к кому-чему]
непримиримый	[к кому-чему]
неприспособленность	[к чему]
неприступный	[для кого-чего]
неприхотливый	[в чем]
непричастность	[к чему]
непричастный	[к чему]
неприятный	[кому, для кого]
непроницаемый	[для чего]
непростительный	[для кого-чего]
неразборчивый	[в чем]
нервировать	[кого]
несамостоятельность	[чего, в чем]
несведущий	[в чем]
несдобровать	[кому]
несовместимый	[с чем]
несовместный	[с чем]
несогласие	[в чем, с кем-чем]
несогласованность	[в чем]
несообразность	[чего, с чем]
несообразный	[с чем]
несоответствие	[чего, чему, с чем, между чем]
несоразмерность	[с чем]
несоразмерный	[с чем, чему]
несостоятельность	[чего, в чем]
неспособный	[к чему, на что]
нетерпимый	[к кому-чему]
неуверенность	[в чем]
неугодный	[кому]
неудачливый	[в чем, на что]
неудобный	[кому, для кого]
неукротимый	[в чем]
неуловимый	[для кого-чего]
неумеренность	[чего, в чем]
неуязвимый	[для кого-чего]
нужный	[кому, для кого, для чего, на что]
обвинять	[в чем, за что]
обворожить	[кого, чем]
обвязать	[кого-что, чем]
обдать	[кого-что, чем]
обежать	[что, вокруг чего]
обезболить	[что]
обезводить	[что]
обезволить	[кого]
обезвредить	[кого-что]
обезгазить	[что]
обезглавить	[кого-что]
обезденежить	[кого]
обездолить	[кого]
обезжирить	[то]
обеззаразить	[что]
обезземелить	[кого]
обезлесить	[что]
обезлиствить	[что]
обезличить	[кого]
обезлюдить	[что]
обезнадежить	[кого]
обезобразить	[кого-что]
обезопасить	[кого-что]
обезоружить	[кого]
обезьянничать	[кого-что]
обелиск	[кому]
оберегать	[кого-что, от кого-чего]
обернуть (обвернуть)	[что, во что, чем]
обернуться	[в кого, кем]
обескровить	[кого]
обескрылить	[кого-чего]
обескуражить	[кого]
обеспечить	[кого, чем, кому, что]
обесплодить	[что]
обеспокоить	[кого]
обеспылить	[что]
обессилить	[кого]
обесславить	[кого]
обессмертить	[кого-что]
обессмыслить	[что]
обессолить	[что]
обесточить	[что]
обесцветить	[что]
обесценить	[что]
обещать	[кому, что]
обзавести	[кого, чем]
обзирать	[кого-что]
обида	[на кого-что]
обидеть	[кого, чем]
обидеться (обижаться)	[на что, чем]
обидный	[кому, для кого]
обиженный (обижен)	[кем-чем, на кого-что]
обиловать	[чем]
обильный	[кем-чем]
облачить (облачиться)	[во что]
облепить	[что, чем]
облечь  (облекать)	[чем, во что]
облечь  (облегать)	[что, чем]
обличать	[кого-что]
облокотить	[что, на что]
облокотиться	[на что, обо что]
обляпать	[что, чем]
обмакнуть	[что, во что]
обмануться	[в ком-чем]
обмахнуть	[что, чем]
обмежевать	[что]
обменить	[что, на что]
обменять	[что, на что]
обменяться	[чем, с кем]
обмотать	[что, чем]
обмочить	[что, чем]
обмундировать	[во что]
обнести	[кого-что, чем]
обновить	[что]
обогатить	[кого-что, чем]
обойти	[что, вокруг чего]
оборонять	[кого-что, от кого-чего]
обосновать (обосновывать)	[что, чем, на чем]
обрадованный (обрадован)	[чем, чему]
обрадовать	[кого, чем]
обрадоваться	[кому-чему, чем]
обратный	[чему]
обращаться	[с кем, с чем]
обременить	[кого, чем]
обретаться	[где (в чем)]
обречь	[чему, на что]
обрызгать	[кого-что, чем]
обрядить	[кого, во что]
обрядиться	[во что]
обсадить	[что, чем]
обсесть	[кого-что]
обставить	[кого-что, чем]
обтереть	[что, чем]
обтесать	[что, чем]
обтянуть	[что, чем]
обуревать	[кого, чем]
обучить	[кого, чему]
обхватить	[что, чем]
обход: в обход	[чего, кому-чему]
обходительный	[с кем]
обчистить	[кого-что]
обшить	[что, чем]
объединить	[во что, в чем]
объесться	[чем, чего]
объехать	[что, вокруг чего]
объявить	[что, о чем]
объявление	[чего, о чем]
объяснение	[чего, чему]
обычный	[для кого-чего]
обязан	[кому-чему, чем]
оглушить	[кого, чем]
огородить	[что, чем]
огорчаться	[чему, чем]
огорченный (огорчен)	[чем, чему]
огорчить	[кого, чем]
оградить	[что, чем]
ограничить	[кого-что, кем-чем, в чем]
одарить	[кого, чем]
оделить	[кого, чем]
одержимость	[чем]
одержимый	[чем]
одеть	[кого-что, во что, чем]
одобрение	[чего, чему]
одолжить	[что, чего, кого]
ожесточиться	[к кому-чему]
ожидать	[чего, кого-что]
озаботить	[кого]
озаботиться	[кем-чем, о ком-чем]
озабоченность	[чем, за что]
озарить	[кого-что, чем]
озирать	[кого-что]
ознаменовать	[кого-что, чем]
окаймить	[что, чем]
окатить	[кого-что, чем]
оковать	[что, чем]
околдовать	[кого, чем]
окрестить	[кого-что, кем-чем]
окружить	[кого-что, кем-чем]
окультурить	[что]
окунуть	[что, во что]
окупить	[что, чем]
окутать	[кого-что, чем, во что]
олицетворить (олицетворять)	[что]
омрачить	[что, чем]
опасаться	[кого-чего, за кого-что]
опасный (опасен)	[кому, для кого-чего]
опахнуть	[что, чем]
опереться	[на кого-что, обо что]
оперировать	[чем, с чем]
опись	[чего, чему]
оплата	[чего, за что]
оплатить	[что, за что]
оплести	[что, чем]
оплодотворить	[что, чем]
оповестить	[кого о чем]
опоить	[кого, чем]
ополчиться	[на кого-что, против кого-чего]
опора	[кому, для кого]
опоясать	[кого-что, чем]
опустить	[кого-что, куда]
опутать	[кого-что, чем]
опыт (опыты)	[чего, в чем, по чему, с кем]
опытный	[в чем]
оригинальный	[в чем, по чему]
ориентировать	[кого-что, на что, в чем]
осведомить	[кого о чем]
осведомленный	[в чем, о чем]
освежить	[что, чем]
осветить	[что, чем]
освободить	[кого-что, от кого-чего]
оскандалить	[кого]
оскоблить	[что, чем]
оскорбительный	[для кого-чего]
оскорбить	[кого-что, чем]
оскорбиться	[чем, на что]
ослепить	[кого, чем]
осложнить	[что, чем]
ослушаться	[кого-чего]
осмелиться	[на что]
оснастить	[кого-что, чем]
основать	[что, на чем]
основываться	[на чем, чем]
оставить	[кому, что]
остатки	[чего, от чего]
остаться	[кому, для кого]
осуждать	[в ком, у кого]
осужденный	[на что]
осыпать	[кого-что, чем]
отбавить	[что, чего]
отвадить	[кого от чего]
отведать	[что, чего]
отвезти	[что, чего, кому, к кому]
отвесить	[что, чего]
ответить	[на что, чем, за кого-что]
ответственность	[чего, за что, перед кем]
отвечать	[за кого-что, чему]
отграничить	[что, чего]
отдавать	[что, чем]
отдарить	[чем]
отделаться	[от чего, чем]
отделить	[кого-что, от кого-чего]
отзыв	[о чем, на что]
отзывчивый	[к чему, на что]
отказ	[в чем, от чего]
отказать	[кому в чем, от чего, в чем]
открыть	[кому, для кого]
открыться	[кому, перед кем]
откусить	[что, чего]
отлить	[что, чего]
отличаться	[чем, в чем]
отличить	[что, от чего]
отложить	[для кого, кому, на что]
отмести	[что от чего]
отметка	[за что, по чему, тд за что]
отмечать	[что]
отнести	[что, чего, кому, к кому]
относиться	[к кому-чему, до кого-чего]
отношение:	[кого-чего, к кому-чему]
отношения	[кого, и между кем]
отнять	[от кого, у кого]
отобрать	[у кого, от кого]
отозваться	[чем, на ком-чем, о ком-чем]
отослать	[кому, к кому]
отпить	[что, чего]
отплеснуть	[что, чего]
отправить	[кому, к кому]
отрезать	[что, чего]
отрубить	[что, чего]
отсосать	[что, чего]
отсрочка	[чего, в чем]
отстать	[от кого-чего, в чем]
отстоять	[что, от чего]
отстоять	[от чего]
отсыпать	[что, чего]
оттаять	[что]
отхлебнуть	[что, чего]
отцедить	[что, чего]
отчерпнуть	[что, чего]
отчет	[о чем, в чем]
отчитаться	[в чем и, о чем]
отяготить	[что, чем]
охарактеризовать	[что]
охота	[кому, к чему]
охотиться	[за кем, на кого]
охотник	[до чего, на что]
охочий	[до чего, к чему, на что]
охранять	[кого-что, от кого-чего]
оценка	[кого-чего, кому-чему]
очевидец	[чего]
очевидный	[для кого]
очерк	[чего, по чему]
очерки	[чего, по чему]
падать	[куда (на что, во что), где, куда]
падкий	[на что, до чего, к чему]
памятка	[кому, для кого]
памятник	[кому-чему]
памятный	[кому, для кого]
память	[кого-чего, о ком-чем]
панихида	[о ком, по кому, по ком]
параллельно	[чему, с чем]
парировать	[что]
пародия	[на что]
партнер	[по чему, в чем]
пасовать	[перед кем-чем]
пасовать	[кому, куда]
патентовать	[что]
патриот	[чего]
патронировать	[кого]
патрулировать	[что]
пачкать (запачкать)	[что, чем]
пенять	[кому, за что, на что]
перебазировать	[кого-что]
перебежать	[что, через что]
перебирать	[что, чем]
перебой	[в чем, с чем]
перебрать	[что, чего]
перевалить	[что, через что]
перевернуть	[что, с чего, на что]
перевести	[что, с чего, на что]
переговорить	[что, о чем]
передарить	[что, чего]
передать	[что, чего]
передать	[что, с чего, на что]
переесть	[чего]
переехать	[что, через что]
переживать	[из-за кого-чего, о ком-чем, за кого-что]
перейти	[что, через что]
перекрестить	[в кого-что, кем-чем]
перекусить	[чего, что]
перекушать	[чего]
перелететь	[что, через что]
переложить	[что, чего]
перемазать	[что, чем]
перемарать	[что, чем]
перемахнуть	[что, через что]
перемежать	[чем, с чем]
перемежаться	[чем, с чем]
перемотать	[что, с чего на что]
переодеться	[кем, в кого]
переписать	[что, с чего, на что]
перепить	[чего]
переплыть	[что, через что]
переползти	[что, через что]
переполнить	[что, чем]
перепрыгнуть	[что, через что]
перерасти	[что, во что]
перескочить	[что, через что]
переступить	[что, через что]
пересыпать	[что, чего]
перехватить	[что, чего]
перешагнуть	[что, через что]
перпендикулярный (перпендикулярно)	[чему, к чему]
пестовать	[кого]
петь	[что, о чем]
печалить	[кого]
печалиться	[о ком-чем]
печалиться	[о ком-чем]
печаловаться	[о ком-чем]
печься	[о ком-чем]
писать (написать)	[что, о чем, про кого-что, кому]
письмо	[кому, от кого]
плакать	[о ком-чем, по кому-чему, над кем-чем]
платить	[чем за что]
пленить	[кого, чем]
плескать	[что, чем]
плеснуть	[что, чего]
поведать	[что, о чем]
повесить	[на что, на чем, где]
повод	[для чего, к чему]
погрузить	[что, во что]
подарок	[кому, для кого]
подать	[что, чего]
подбавить	[что, чего]
подбросить	[кому, к кому]
подбросить	[что, чего]
подвалить	[что, чего]
подварить	[что, чего]
подвезти	[что, чего]
подвесить	[что, на что]
подготовить	[кого-что, к чему]
подготовка	[чего, к чему]
подгрузить	[что, чего]
поддаваться	[чему, на что]
поддать	[чего]
поддержка	[кому, для кого]
поджарить	[что, чего]
поджидать	[кого, чего]
подзаработать	[что, чего]
подивиться	[кому-чему, на кого-что]
подкинуть	[что, чего]
подклеить	[что, чего]
подключиться	[во что, к чему]
подколоть	[что, чего]
подкопить	[что, чего]
подкупить	[что, чего]
подладиться	[к кому-чему, подо что]
подлить	[что, чего]
подложить	[что, чего]
подмесить	[что, чего]
подмешать	[что, чего]
подмотать	[что, чего]
поднакопить	[что, чего]
поднести	[что, чего]
поднять	[куда, где]
подобать	[кому-чему]
подобный	[кому-чему]
подогнать	[что, к чему]
пододвинуть	[что, к чему]
подождать	[кого, чего]
подозревать	[в чем, о чем]
подозрение	[на кого, против кого, в чем, о чем]
подойти	[кому, для кого]
подходить	[кому, для кого]
подольститься	[к кому]
подотчетный	[кому, перед кем]
подписка	[на что, о чем]
подпустить	[что, чего]
подражать	[кому-чему, в чем]
подрезать	[что, чего]
подрубить	[что, чего]
подрыть	[что, чего]
подсадить	[что, чего]
подсеять	[что, чего]
подстрекать (подстрекнуть)	[к чему, на что]
подсыпать	[что, чего]
подтащить	[кого-что, к чему]
подтверждение	[чего, чему]
подтолочь	[что, чего]
подтопить	[что, чего]
подтянуть	[кого-что, к чему]
подучить	[что, чему]
подходить	[кому, для кого-чего, к кому-чему]
подходящий	[для чего, на что, кому]
подчеркивать	[что, о чем]
подчинить	[кого-что, кому-чему]
поесть	[что, чего]
пожевать	[что, чего]
позаимствовать	[что, чего]
поздравить	[кого с чем]
поискать	[что, чего]
показать	[кого-что, на кого-что]
покладистый	[с кем, по отношению к кому]
поклевать	[что, чего]
поколоть	[что, чего]
покончить	[с чем, что]
покорный	[кому-чему]
покорствовать	[кому-чему]
покосить	[что, чем]
покрошить	[что, чего]
покрутить	[что, чем]
покупатель	[чего, на что]
покушать	[что, чего]
полезный	[кому-чему, для кого-чего]
полет	[куда, где]
ползти	[куда, где]
поливать	[чем, из чего]
полный	[кого-чего, кем-чем, чего, чем]
положить	[куда, где]
получить	[от кого, у кого, с кого]
пользовать	[кого]
пользоваться	[среди кого, у кого]
поместить	[куда, где]
поминать	[кого-что, о ком-чем]
помириться	[с кем, с чем, на чем]
помнить	[что, о чем]
понаблюдать	[кого-что, за кем-чем, над кем-чем]
понабрать	[что, чего]
понабросать	[что, чего]
понавезти	[что, чего]
понавести	[что, чего]
понавешать	[что, чего]
понавешать	[что, чего]
понавозить	[что, чего]
понавязать	[что, чего]
понагнать	[кого-что, чего]
понадавать	[что, чего]
понаделать	[что, чего]
понакидать	[что, чего]
понаклеить	[что, чего]
понанести	[что, чего]
понапихать	[что, чего]
понаснимать	[что, чего]
понасобирать	[что, чего]
понасовать	[что, чего]
понаставить	[что, чего]
понастроить	[что, чего]
понатаскать	[что, чего]
понатыкать	[что, чего]
понахватать	[что, чего]
понашить	[что, чего]
понаштопать	[что, чего]
понимать	[что, в чем]
поносить	[кого, чем]
понятный	[кому, для кого]
поползти	[куда, где]
попомнить	[что]
попрекнуть	[чем, за что, в чем]
попробовать	[что, чего]
попросить	[что, чего, о чем]
попустительствовать	[кому-чему]
попытать	[что, чего]
поражаться (поразиться)	[чем, чему]
порезать	[что, чего]
порицать	[что, за что]
порождать [что]
порубить	[что, чего]
поручить	[кому кого-что]
посадить	[на что, кого-что]
посбавить	[что, чего]
посбирать	[что, чего]
посбить	[что, чего]
посвятить	[чему, на что]
поселить	[куда, где]
послание	[кому, к кому]
послать	[кому]
посылать	[кому]
последовать	[за кем-чем, чему]
послушный	[чему]
посолить	[что, чего]
посредство:	[кого-чего]
поставить	[куда, где]
постоянство	[чего, чем]
построить   [что]
постоять	[за кого-что]
поступить	[с кем, по отнощению к кому]
посушить	[что, чего]
посы/пать	[что, чего]
потакать	[кому (в чем), чему]
потворствовать	[чему]
потеря (потери)	[чего, в чем]
потрафить	[кому-чему, на кого-что]
потребность	[в чем, чего]
потрясти	[что, чем]
потчевать	[чем]
похлебать	[что, чего]
походить	[чем, почему]
похожий	[чем, на кого-что]
почерпать	[что, чего]
почерпнуть	[что, чего]
почтительный (почтителен)	[к кому, с кем]
пошвырять	[что, чем]
прав	[перед кем]
правда	[чего, о чем]
править	[кем-чем, кого-что]
превалировать	[над чем]
превозмочь	[что]
превосходить	[кого-что, чем, в чем, по чему]
превосходство	[над кем-чем, перед кем-чем, в чем]
превращение	[кого-чего, в кого-что]
преградить	[кому-чему, что]
предать	[кому, чему]
предварить	[что, о чем]
предвещать	[что]
предводительствовать	[кем]
предвосхитить	[что]
предназначить	[кому, для кого]
предначертать	[что]
предоставить	[что, кому]
предостеречь	[от чего, против чего]
предотвратить	[что]
предохранить	[кого-что от чего]
предпослать	[что, чему]
предпосылка	[чего, для чего, к чему]
предпочесть	[кого-что, кому-чему]
предприимчивый	[в чем]
предрасполагать	[к чему]
представитель	[кого-чего, от кого-чего]
представить	[что, чем, к чему]
предстать	[перед кем-чем, кому-чему]
предстоять	[кому-чему]
предубеждение	[против кого-чего]
предубежденный	[против кого-чего]
предуведомить	[о чем]
предугадать	[что]
предупредительный	[с кем, по отношению к кому]
предупредить	[что, кого, о чем]
предъявить	[кому, к кому]
преемник	[кого, кому]
преемственность	[чего, в чем, чему]
презирать	[в ком, у кого]
презрение	[чего, к чему]
презреть	[что]
преимущество	[перед кем-чем, в чем]
преисполненный	[чего, чем]
преисполнить	[чем]
преисполниться	[чем, чего]
прекословить	[кому]
прелюдия	[чего, к чему]
премировать	[кого, за что, чем]
пренебрежение	[чем, к чему]
пренебречь	[кем-чем, кого-что]
преобладать	[над чем]
преобразовать	[что, во что]
преобратить	[что, во что]
преодолеть	[что]
препираться	[с кем из-за чего]
преподать	[кому, что]
преподнести	[кому, что]
препоручить	[кого-что, кому-чему]
препятствовать	[кому-чему, в чем]
пререкаться	[с кем, из-за чего]
преследовать	[кого-что, чем]
пресмыкаться	[перед кем]
преступление	[против чего]
пресытиться	[чем]
претворение	[чего во что]
претворить	[что, во что]
претвориться	[во что]
претендент	[на что]
претендовать	[на что, на кого]
претензия	[к кому, на что, за что]
претерпеть	[что]
претить	[кому]
преуспевать (преуспеть)	[в чем]
прибавить	[что, чего]
прибегнуть	[к кому-чему]
приберегать (приберечь)	[что]
прибить	[что, к чему, на что]
приблизить	[что, к чему]
приболтать	[что, чего]
прибросить	[что, чего]
прибуксировать	[что, к чему]
привалить	[что, к чему]
приварить	[что, чего]
привезти	[что, чего, кому, к кому]
приверженность	[кому-чему, к кому-чему]
приверженный	[кому-чему, к кому-чему]
привернуть	[что, к чему]
привесить	[что, к чему]
привесить	[что, чего]
приветливый	[с кем, к кому]
привилегии	[кому, для кого]
привинтить	[что, к чему]
привить	[что, к чему]
привлекательный	[для кого]
привлечь	[кого-что, к чему]
привнести	[что, во что]
приволочь	[что, чего]
приворожить	[кого к кому]
привычный	[к чему, для кого, кому-чему]
привязать	[кого-что к кому-чему]
пригвоздить	[кого-что, к чему]
приглядеть	[кого-что, за кем-чем]
приговор	[о чем]
приговорить	[к чему и, на что]
пригодиться	[кому, для чего, на что]
пригодный	[для чего, к чему]
приготовить	[что, , для чего, к чему]
приготовить	[что, чего]
пригрести	[что, к чему]
пригубить	[что, чего]
придать	[что, чего]
придвинуть	[что, к чему]
приделать	[что, к чему]
придерживаться	[за что, чего]
придраться	[к кому, к чему]
приемлемый	[для кого-чего]
прижать	[кого-что, к чему]
призанять	[что, чего]
призвать (призывать)	[к чему, на что, что, на кого-что]
приземлиться	[где, куда]
признание	[чего, в чем]
признательный	[кому, к кому]
прикинуть	[что, чего]
приклеить	[что, на что, к чему]
приклонить	[что, к чему]
приковать	[кого-что, к чему]
приколотить	[что, к чему]
приколоть	[что, к чему]
прикопить	[что, чего]
прикрепить	[кого-что, к чему, куда, где, к чему]
прикрутить	[что, к чему]
прикрыть	[что, чем]
прикупить	[что, чего]
приладить	[что, к чему]
прилепить	[что, на что, к чему]
прилечь	[на что, где, куда]
прилить	[что, чего]
приложить	[что, к чему]
приляпать	[что, к чему]
пример	[чего, чему]
примесить	[что, чего]
приметать	[что, к чему]
приметный	[чем, по чему]
примешать	[что, чего]
примотать	[что, чего]
принадлежать	[кому-чему, к кому-чему]
принакопить	[что, чего]
принести	[что, чего, кому, к кому]
принимать	[от кого, у кого]
приноровить	[что, к чему]
принять	[что, чего]
приобщить	[кого к чему, что, к чему]
приохотить	[кого к чему]
припасти	[что, чего]
припаять	[что, к чему]
приплести	[что, к чему]
приравнять	[что, к чему]
прирезать	[что, чего]
присадить	[что, чего]
присесть	[куда, где]
присеять	[что, чего]
прислать	[что, чего]
прислонить	[что, к чему]
присмотреть	[кого-что, за кем-чем]
присовокупить	[что, к чему]
присоединить	[что, к чему]
приспособить	[к чему, для чего, подо что]
приставить	[что, к чему]
пристроить	[что, к чему]
пристегнуть	[что, к чему]
присудить	[кого к чему, кому, что]
присущий	[кому-чему]
присчитать	[кому к чему]
присыпать	[что, чего]
притачать	[что, к чему]
притащить	[что, чего]
притереть	[что, к чему]
притесать	[что, к чему]
притязать	[на что]
притянуть	[что, к чему]
приурочить	[что, к чему]
приучить	[кого к чему]
прихватить	[что, чего]
прихлестнуть	[что, к чему]
прицепить	[что, к чему]
причалить	[что, к чему]
причастность	[к чему]
причастный	[к чему, чему]
причина (причиной)	[чего к чему, чего, чему]
причислить	[кого-что к кому-чему]
причитать	[по кому, по ком]
пришвартовать	[что, к чему]
пришить	[что, к чему]
пришпилить	[что, к чему]
приятный	[кому, для кого]
проведать	[кого-что, что, о ком-чем]
провести	[что, кого, куда]
проводить	[что, кого, куда]
провозглашать	[кого кем]
провоцировать	[кого, на что]
проглядеть	[что, на что]
продолжение:	[чего]
проехать	[что, через что]
пройти	[что, через что]
прок	[в ком-чем, от кого-чего]
пролог	[чего, к чему]
проиграть [кому, чему]
промыслить	[что, чего]
промышлять	[чем, кого-что]
пропорциональный	[чему]
прорезать	[что, чем]
прорубить	[что, чем]
просверлить	[что, чем]
просить	[чего, что, о ком-чем, за кого, о чем]
проследить	[кого, что, за чем]
простить	[кого, за что, кому, что]
протежировать	[кому, кого]
протестовать	[против чего]
противник	[чего и, чему]
противный	[чему]
проткнуть	[что, чем]
процент	[чего, от чего]
процесс	[кого, над кем]
прочитать	[что, о чем]
прочить	[в кого, кем]
прятать	[куда, где]
прятаться	[за что, за чем, от кого]
путать	[кого, во что]
путь	[чего, к чему]
работать	[для кого, на кого]
равносильный	[для кого, чему]
равный	[кому-чему, с кем-чем, для кого-чего, чему]
равнять	[что с чем]
равняться	[на кого, по кому]
рад	[кому-чему, за кого]
радеть	[о ком-чем, за кого-что, кому-чему]
радоваться	[кому-чему, кем-чем, за кого]
радостный	[для кого]
радость	[за кого-что, о ком-чем, о ком-чем]
разбавить	[что, чем]
развевать	[что, чем]
развивать (развить)	[в ком, у кого]
разговаривать	[о чем, про что, с кем]
разговорить	[кого]
разграничить	[что, от чего]
раздобыть	[что, чего]
раздражаться	[чем, на что]
раздумывать	[над чем, о чем]
разжиться	[чем и, чего]
различаться	[чем, по чему]
различить	[что, что от чего]
разнообразить	[что, чем]
разобраться	[в чем, с чем]
разойтись	[в чем, на чем, чем]
разочарован	[кем-чем, в чем]
разочарование	[в ком-чем]
разочароваться	[в ком-чем]
разохотиться	[на что]
разубедить	[кого, в чем]
разуверить	[кого, в чем]
разувериться	[в чем]
располагать	[чем, к чему]
расправа	[с кем, над кем]
рассердиться	[на что]
рассерженный (рассержен)	[чем]
рассказать	[что, про что, о чем]
растаять	[что]
реакция	[чего на что]
реализовать [что]
реестр	[чего, чему]
рекомендовать	[для чего, на что, к чему, в кого]
рекорд	[чего, по чему, в чем]
репетировать	[кого-что]
рецензия	[на что, о чем)]
решение	[чего, о чем]
риск	[чего, для чего, чем]
робеть	[перед кем-чем, кого]
ровесник	[кого-чего, кому-чему]
родной	[кому, для кого]
родня	[кого, кому]
роковой	[для кого-чего]
роптать	[на что, за что]
роспись	[чего, чему]
руководитель	[чего, чем]
руководить	[кем-чем, кого-что]
руководство	[чем, чего]
руководствовать	[кого]
садиться	[куда, где]
сажать	[что, на что, во что]
самостоятельность	[чего, в чем]
свалить	[куда, где]
сварить	[что, чего]
сватать	[кому, за кого]
свататься	[за кого, к кому]
сведущий	[в чем]
сверить	[что с чем]
свести	[к чему, до чего, на что]
свидетель	[чего, чему]
свидетельство	[чего, чему]
свидетельствовать	[что, о чем]
свойственный	[кому, для кого]
своротить	[кого-что, с чего]
связать	[что, чем]
связь	[чего, между чем]
сесть	[куда (на что), где, куда]
сетовать	[на что]
сигнал	[чего, к чему, о чем]
сигнализировать (сигналить)	[что, о чем]
сила:	[чего]
сильный	[чем, в чем, по чему]
симпатичный	[кому, чем]
синтезировать [что, с чем]
скандальный	[для кого]
скидка	[кому, для кого, на что]
складывать	[куда, где]
склонить	[к чему, на что]
склониться	[к чему, на что]
скорбеть	[о ком, по кому, по ком, за кого, над кем]
скрыться (скрываться)	[куда, где]
скудный	[кем-чем]
скучать	[о ком-чем, по кому-чему, по ком-чем]
след (следы)	[чего, от чего]
следить	[за кем-чем, кого-что]
следовать	[кому-чему, за кем-чем]
слиться	[во что, в чем]
сложить	[куда, где]
служба	[у кого, кому]
служить	[кому-чему, чем, для чего]
случаться	[с кем, у кого, среди кого]
слушаться	[кого]
слыть	[кем, за кого]
слышать	[что, о чем]
смеяться	[над кем-чем, кому-чему, чему, на что]
смириться	[с чем, перед чем]
смотр	[чего, чему]
смотреть	[что, на кого-что, на что]
смыслить	[в чем, что]
снести	[кому, к кому]
снизойти	[до кого-чего, к кому-чему]
снисходительный	[к кому-чему]
собирать	[с кого, от кого, у кого]
соблазнить	[кого, чем]
соблазниться	[чем, на что]
соболезновать	[кому-чему в чем]
собрать	[что, чего]
собрать	[куда, где]
собраться	[куда, где]
совершенствоваться	[в чем, по чему]
совеститься	[чего]
совещание	[о чем, по чему]
совпасть	[чем, по чему]
согласиться	[на что, с чем, о чем, на чем]
согласно	[чему, чего, с чем]
согласный	[с чем, на что]
согласен	[с чем, на что]
содержать   [что, в чем]
содержиться [что, в чем]
созвучный	[чему, с чем]
создать	[что, для кого]
сойтись	[в чем, чем]
сообразно	[чему, с чем]
сообразовать	[что с чем]
сообщение	[чего, о чем]
сообщить	[что, о чем]
соответственно	[чему и, с чем]
соответствие	[чему, между чем, с чем]
соответствовать	[чему, с чем]
соотношение	[чего, между чем]
сопричастный	[чему]
соразмерно	[чему, с чем]
соразмерный	[чему, с чем]
соревноваться	[за что, на что, в чем, почему, по чему]
соскучиться	[о ком-чем, по кому-чему, по ком-чем]
составлять [что]
состоять	[из кого-чего, в чем]
состязание	[в чем, по чему]
сочувствие	[кому-чему, к кому-чему]
специализироваться	[по чему, в чем, на чем]
список	[кого-чего, кому-чему]
спор	[кого, между кем, с кем]
спорить	[о чем, из-за чего, против чего, с чем, за что]
способность	[к чему, на что]
способный	[к чему, на что]
способствовать	[кому-чему, к чему]
споспешествовать	[кому-чему, к чему]
справедливый	[к кому, с кем]
спрашивать	[чего и, что]
спрос	[на кого-что]
спросить	[что, о чем, чего, кого, у кого]
спрятать	[куда, где]
спрятаться	[за что, от кого]
сравнение:	[с чем]
сравнить	[кого-что, с кем-чем]
сражаться (сразиться)	[с кем-чем и, против кого-чего]
средства	[для чего, к чему]
среагировать	[на что]
средство	[от чего, против чего]
ссора	[кого, между кем]
ставить	[куда, где]
стандарт (стандарты)	[чего, на что]
стартовать	[куда, где, откуда]
стать	[кем-чем]
стеречь	[кого-что, от кого-чего]
стеречься	[от кого-чего]
стесняться	[кого-чего, в чем]
стимул	[чего, для чего, к чему]
стоить	[что, чего]
сторож	[кого-чего, кому-чему]
страдать	[чем, от чего, по кому-чему, за кого-что, из-за кого-чего]
страх	[чего, к чему, перед чем]
страховать (застраховать)	[кого-что, от чего]
страшиться	[чего, перед чем, за кого]
страшный	[чем, в чем]
стрелять	[в кого, по кому-чему, по ком-чем]
стремить	[кого-что]
строгий	[с кем, к кому]
стучать	[во что, по чему]
стучаться	[во что, обо что]
стыдиться	[кого-чего, за кого-что, кого, чего, за кого, за что]
счастливый	[чем]
счет	[чего, чему]
считать	[кем-чем, за кого-что]
сыпать	[что, чем]
тактичный	[с кем, по отношению к кому]
талант	[к чему и, на что]
тенденция	[чего, к чему]
тесный (тесен)	[кому, для кого]
течение:	[чего, чего:]
типичный	[для кого-чего]
товарообмен	[кого, между кем]
тождественный	[чему, с чем]
толковать	[что и, о чем, что]
торг	[чем]
торговать	[чем, что]
тормозить	[что]
тоска	[о ком-чем, по кому-чему]
тосковать	[о ком-чем, по кому-чему]
трактовать	[что, о чем, о чем и]
траур	[по кому, по ком]
тратить [что, на что]
требование (требования)	[чего, о чем, кого-чего, к кому-чему]
требовать	[чего и, что, чего, от кого, у кого, с кого]
тревожиться	[за кого-что, о ком-чем]
трепетать	[перед кем-чем, при ком-чем]
трогательный	[чем, в чем]
трудный	[кому, для кого]
трясти	[что, чем]
тугой	[на что, к чему]
туг	[на что, к чему]
тужить	[о ком-чем, по кому-чему, о ком-чем]
тяготеть	[к кому-чему, над кем-чем, на ком]
тяготить	[кого-что, над кем, на ком]
тяжело	[кому, для кого]
тянуть	[что, за что]
тянуть	[на что, к чему]
у	[кого-кого]
убавить	[что, чего, в чем]
убегать	[кого-чего]
убеждать (убедить)	[кого, в чем]
убиваться	[о ком-чем, по кому-чему, из-за кого-чего]
уверенность	[в чем, во что]
уверенный	[в ком-чем]
уверить	[в чем]
увернуть	[во что, в чем]
уверовать	[во что]
увеселять	[кого, чем]
увести	[от кого, у кого]
увешать	[что, чем]
увиваться	[около кого-чего]
увильнуть	[от чего]
увлажнить	[что, чем]
увлечь	[кого, чем]
увязать	[что, чем]
увязнуть	[в чем]
углубиться	[во что]
угода	[кому-чему, кого-чего]
угодить	[кому-чему, на кого-что]
уготовить	[кому, что]
угроза	[кому-чему, для кого-чего]
удалиться (удаляться)	[от кого-чего, кого-чего]
удар	[чего, чем]
ударить	[во что, по чему, чем]
удариться	[обо что, во что]
удачливый	[в чем]
удивиться (удивляться)	[кому-чему, на кого-что]
удивлен	[чем]
удобно	[кому]
удобный	[для кого-чего, кому]
удовлетворить (удовлетворять)	[что, чему, чем]
удовольствие	[чего, от чего]
удостоить	[чего, чем]
ужаснуться	[чему, перед чем]
ужинать (поужинать)	[чем]
узкий (узок)	[кому, для кого]
узнать	[что, о чем]
указание	[на что, о чем]
указать	[что, на что]
укладывать	[во что,  в чем]
уклончивый	[в чем]
укорять (укорить)	[в чем]
украсить	[кого-что, чем]
укутать	[чем, во что]
уложить	[что, во что]
улучшение	[чего, в чем]
улыбнуться	[чему, на что]
уместиться	[что, в чем]
умилиться (умиляться)	[кем-чем, кому-чему, на кого-что, над кем-чем]
унаследовать	[от кого, у кого]
унизительный	[для кого]
упасть	[куда, где, на что, кому, к кому]
упереться	[во что, обо что, на что]
уплатить	[что, за что]
уподобиться	[кому-чему в чем]
уполномоченный	[кого-чего, по чему]
уполномочить	[на что, к чему]
упомянуть	[кого-что, о ком-чем, про кого-что]
упор	[на что, на чем]
употребить	[для чего, на что]
управление	[чем, чего]
управляющий	[чем, чего)]
упражняться	[в чем, на чем, с чем]
упрекать	[в чем, за что, чем]
упрятать	[куда, где]
уравнять	[кого-что в чем, с кем-чем]
усадить (усаживать)	[что, на что]
усаживаться (усесться)	[на что]
усвоить	[кому]
усеять	[что, чем]
уследить	[кого-что, за кем-чем, за чем]
условие (условия)	[чего, для чего]
услышать	[что, о ком-чем]
усмотреть	[кого-что, за кем-чем, в чем]
успеть	[к чему, на что]
уставить	[на что, на чем]
установить	[куда, где]
устойчивость	[к чему, против чего]
устойчивый	[в чем, против чего, к чему]
устоять	[против чего, от чего]
устремить	[к чему, на что]
устроиться	[куда, где]
уступить	[кому, что, в чем]
утверждать	[что, о чем]
участник	[чего]
учет	[чего, чему]
учить	[кого, чему]
учиться	[на кого]
учтивый (учтив)	[с кем]
факт	[чего, о чем]
фрагмент	[чего, из чего]
формировать [что]
характеристика	[кого, на кого]
характерный	[для кого-чего, кому-чему]
хвастаться	[кому, перед кем]
хватить	[что, чего]
хватиться	[кого-чего, о ком-чем]
хлебнуть	[что, чего]
хлестать	[по чему, во что]
хлопать	[по чему, что]
хлопотать	[о чем, над чем]
хлопотать	[перед кем, у кого, за кого, о ком]
ходатайствовать	[о ком-чем, за кого-что]
ходить	[в ком, кем]
хозяин	[чего, чему]
хороший (хорош)	[кому, для кого, чем, по чему]
хотеть	[чего, что]
цель:	[чего]
цена	[чего, кому-чему, за что, на что]
ценить	[в ком, у кого]
часть	[чего, от чего]
чаять	[чего]
черпнуть	[что, чего]
читать	[что, о чем]
чуждый	[кому-чему, для кого-чего, чего]
чужой	[кому, для кого]
чуткий	[к чему, на что]
швырять	[что, чем]
шевелить	[что, чем]
широкий (широк)	[кому, для кого]
щедрый	[на что, в чем]
щепетильный	[в чем]
экспериментировать	[с кем-чем, над кем-чем]
явиться	[куда, где]
являться [чем]
ясный	[кому, для кого]
ясность	[чего, в чем]
